NAME	Название реквизита. Обязательное для общих реквизитов.	Да	Да
CODE	Символьный код реквизита.	Да	Да
XML_ID	Внешний ключ, используется для операций обмена. Идентификатор объекта внешней информационной базы. Назначение поля может меняться конечным разработчиком.	Да	Да
ACTIVE	Признак активности.	Да	Да
SORT	Сортировка.	Да	Да
RQ_NAME	Ф.И.О.	Да	Да
RQ_FIRST_NAME	Имя.	Да	Да
RQ_SECOND_NAME	Отчество.	Да	Да
RQ_LAST_NAME	Фамилия.	Да	Да
RQ_COMPANY_NAME	Сокращенное наименование организации.	Да	Да
RQ_COMPANY_FULL_NAME	Полное наименование организации.	Да	Да
RQ_COMPANY_REG_DATE	Дата государственной регистрации.	Да	Да
RQ_DIRECTOR	Ген. директор.	Да	Да
RQ_ACCOUNTANT	Гл. бухгалтер.	Да	Да
RQ_CEO_NAME	ФИО первого руководителя.	Да	Да
RQ_CEO_WORK_POS	Должность первого руководителя.	Да	Да
RQ_CONTACT	Контактное лицо.	Да	Да
RQ_EMAIL	E-Mail.	Да	Да
RQ_PHONE	Телефон.	Да	Да
RQ_FAX	Факс.	Да	Да
RQ_IDENT_DOC	Вид документа.	Да	Да
RQ_IDENT_DOC_SER	Серия.	Да	Да
RQ_IDENT_DOC_NUM	Номер.	Да	Да
RQ_IDENT_DOC_DATE	Дата выдачи.	Да	Да
RQ_IDENT_DOC_ISSUED_BY	Кем выдан.	Да	Да
RQ_IDENT_DOC_DEP_CODE	Код подразделения.	Да	Да
RQ_INN	ИНН.	Да	Да
RQ_KPP	КПП.	Да	Да
RQ_USRLE	Handelsregisternummer (для страны DE).	Да	Да
RQ_IFNS	ИФНС.	Да	Да
RQ_OGRN	ОГРН.	Да	Да
RQ_OGRNIP	ОГРНИП.	Да	Да
RQ_OKPO	ОКПО.	Да	Да
RQ_OKTMO	ОКТМО.	Да	Да
RQ_OKVED	ОКВЭД.