Банковские реквизиты
ID	Идентификатор реквизита. Создается автоматически и уникален в рамках БД.	Да	Нет
ENTITY_TYPE_ID	Идентификатор типа родительской сущности. По умолчанию тип: "Реквизит". Обязательное поле.	Да	Да
ENTITY_ID	Идентификатор родительской сущности. Обязательное поле.	Да	Да
COUNTRY_ID	Идентификатор страны.	Да	Да
DATE_CREATE	Дата создания.	Да	Нет
DATE_MODIFY	Дата изменения.	Да	Нет
CREATED_BY_ID	Идентификатор создавшего реквизит.	Да	Нет
MODIFY_BY_ID	Идентификатор изменившего реквизит.	Да	Нет
NAME	Название реквизита. Обязательное поле.	Да	Да
CODE	Символьный код реквизита.	Да	Да
XML_ID	Внешний ключ, используется для операций обмена. Идентификатор объекта внешней информационной базы. Назначение поля может меняться конечным разработчиком.	Да	Да
ACTIVE	Признак активности.	Да	Да
SORT	Сортировка.	Да	Да
RQ_BANK_NAME	Наименование банка.	Да	Да
RQ_BANK_ADDR	Адрес банка.	Да	Да
RQ_BANK_ROUTE_NUM	Bank Routing Number.	Да	Да
RQ_BIK	БИК.	Да	Да
RQ_MFO	МФО.	Да	Да
RQ_ACC_NAME	Bank Account Holder Name.	Да	Да
RQ_ACC_NUM	Bank Account Number.	Да	Да рс
RQ_IIK	ИИК.	Да	Да
RQ_ACC_CURRENCY	Валюта счёта.	Да	Да
RQ_COR_ACC_NUM	Кор. счёт.	Да	Да
RQ_IBAN	IBAN.	Да	Да
RQ_SWIFT	SWIFT.	Да	Да
RQ_BIC	BIC.	Да	Да
COMMENTS	Комментарий.	Да	Д